new_tiles.png 8 8 320 240

4 9 9 9 9 9 9 9 9 9 9 9 9 9 9 9 9 9 9 9 9 9 9 9 9 9 9 9 9 9 9 9 9 9 9 9 9 9 9 5
6 13 8 8 8 8 8 8 8 8 8 8 8 8 8 8 8 8 8 8 8 8 8 8 8 8 8 8 8 8 8 8 8 8 8 8 8 8 14 7
6 7 10 10 10 10 10 10 10 10 10 10 10 10 10 10 10 10 10 10 10 10 10 10 10 10 10 10 10 10 10 10 10 10 10 10 10 10 6 7
6 7 10 10 10 10 10 10 10 10 10 10 10 10 10 10 10 10 10 10 10 10 10 10 10 10 10 10 10 10 10 10 10 10 10 10 10 10 6 7
6 7 10 10 10 10 10 10 10 10 10 10 10 10 10 10 10 10 10 10 10 10 10 10 10 10 10 10 10 10 10 10 10 10 10 10 10 10 6 7
6 7 10 10 10 10 10 10 10 10 10 10 10 10 10 10 10 10 10 10 10 10 10 10 10 10 10 10 10 10 10 10 10 10 10 10 10 10 6 7
6 7 10 10 10 10 10 10 10 10 10 10 10 10 10 10 10 10 10 10 10 10 10 10 10 10 10 10 10 10 10 10 10 10 10 10 10 10 6 7
6 7 10 10 10 10 10 10 10 10 10 10 10 10 10 10 10 10 10 10 10 10 10 10 10 10 10 10 10 10 10 10 10 10 10 10 10 10 6 7
6 7 10 10 10 10 10 10 10 10 10 10 10 10 10 10 10 10 10 10 10 10 10 10 10 10 10 10 10 10 10 10 10 10 10 10 10 10 6 7
6 7 10 10 10 10 10 10 10 10 10 10 10 10 10 10 10 10 10 10 10 10 10 10 10 10 10 10 10 10 10 10 10 10 10 10 10 10 6 7
6 7 10 10 10 10 10 10 10 10 10 10 10 10 10 10 10 10 10 10 10 10 10 10 10 10 10 10 10 10 10 10 10 10 10 10 10 10 6 7
6 7 10 10 10 10 10 10 10 10 10 10 10 10 10 10 10 10 10 10 10 10 10 10 10 10 10 10 10 10 10 10 10 10 10 10 10 10 6 7
6 7 10 10 10 10 10 10 10 10 10 10 10 10 10 10 10 10 10 10 10 10 10 10 10 10 10 10 10 10 10 10 10 10 10 10 10 10 6 7
6 7 10 10 10 10 10 10 10 10 10 10 10 10 10 10 10 10 10 10 10 10 10 10 10 10 10 10 10 10 10 10 10 10 10 10 10 10 6 7
6 7 10 10 10 10 10 10 10 10 10 10 10 10 10 10 10 10 10 10 10 10 10 10 10 10 10 10 10 10 10 10 10 10 10 10 10 10 6 7
6 7 10 10 10 10 10 10 10 10 10 10 10 10 10 10 10 10 10 10 10 10 10 10 10 10 10 10 10 10 10 10 10 10 10 10 10 10 6 7
6 7 10 10 10 10 10 10 10 10 10 10 10 10 10 10 10 10 10 10 10 10 10 10 10 10 10 10 10 10 10 10 10 10 10 10 10 10 6 7
6 7 10 10 10 10 10 10 10 10 10 10 10 10 10 10 10 10 10 10 10 10 10 10 10 10 10 10 10 10 10 10 10 10 10 10 10 10 6 7
6 7 10 10 10 10 10 10 10 10 10 10 10 10 10 10 10 10 10 10 10 10 10 10 10 10 10 10 10 10 10 10 10 10 10 10 10 10 6 7
6 7 10 10 10 10 10 10 10 10 10 10 10 10 10 10 10 10 10 10 10 10 10 10 10 10 10 10 10 10 10 10 10 10 10 10 10 10 6 7
6 7 10 10 10 10 10 10 10 10 10 10 10 10 10 10 10 10 10 10 10 10 10 10 10 10 10 10 10 10 10 10 10 10 10 10 10 10 6 7
6 7 10 10 10 10 10 10 10 10 10 10 10 10 10 10 10 10 10 10 10 10 10 10 10 10 10 10 10 10 10 10 10 10 10 10 10 10 6 7
6 7 10 10 10 10 10 10 10 10 10 10 10 10 10 10 10 10 10 10 10 10 10 10 10 10 10 10 10 10 10 10 10 10 10 10 10 10 6 7
6 7 10 10 10 10 10 10 10 10 10 10 10 10 10 10 10 10 10 10 10 10 10 10 10 10 10 10 10 10 10 10 10 10 10 10 10 10 6 7
6 7 10 10 10 10 10 10 10 10 10 10 10 10 10 10 10 10 10 10 10 10 10 10 10 10 10 10 10 10 10 10 10 10 10 10 10 10 6 7
6 7 10 10 10 10 10 10 10 10 10 10 10 10 10 10 10 10 10 10 10 10 10 10 10 10 10 10 10 10 10 10 10 10 10 10 10 10 6 7
6 7 10 10 10 10 10 10 10 10 10 10 10 10 10 10 10 10 10 10 10 10 10 10 10 10 10 10 10 10 10 10 10 10 10 10 10 10 6 7
6 7 10 10 10 10 10 10 10 10 10 10 10 10 10 10 10 10 10 10 10 10 10 10 10 10 10 10 10 10 10 10 10 10 10 10 10 10 6 7
6 11 9 9 9 9 9 9 9 9 9 9 9 9 9 9 9 9 9 9 9 9 9 9 9 9 9 9 9 9 9 9 9 9 9 9 9 9 12 7
2 8 8 8 8 8 8 8 8 8 8 8 8 8 8 8 8 8 8 8 8 8 8 8 8 8 8 8 8 8 8 8 8 8 8 8 8 8 8 3

= = = = = = = = = = = = = = = = = = = = = = = = = = = = = = = = = = = = = = = =
= = = = = = = = = = = = = = = = = = = = = = = = = = = = = = = = = = = = = = = =
= = . . . . . . . . . . . . . . . . . . . . . . . . . . . . . . . . . . . . = =
= = . . . . . . . . . . . . . . . . . . . . . . . . . . . . . . . . . . . . = =
= = . . . . . . . . . . . . . . . . . . . . . . . . . . . . . . . . . . . . = =
= = . . . . . . . . . . . . . . . . . . . . . . . . . . . . . . . . . . . . = =
= = . . . . . . . . . . . . . . . . . . . . . . . . . . . . . . . . . . . . = =
= = . . . . . . . . . . . . . . . . . . . . . . . . . . . . . . . . . . . . = =
= = . . . . . . . . . . . . . . . . . . . . . . . . . . . . . . . . . . . . = =
= = . . . . . . . . . . . . . . . . . . . . . . . . . . . . . . . . . . . . = =
= = . . . . . . . . . . . . . . . . . . . . . . . . . . . . . . . . . . . . = =
= = . . . . . . . . . . . . . . . . . . . . . . . . . . . . . . . . . . . . = =
= = . . . . . . . . . . . . . . . . . . . . . . . . . . . . . . . . . . . . = =
= = . . . . . . . . . . . . . . . . . . . . . . . . . . . . . . . . . . . . = =
= = . . . . . . . . . . . . . . . . . . . . . . . . . . . . . . . . . . . . = =
= = . . . . . . . . . . . . . . . . . . . . . . . . . . . . . . . . . . . . = =
= = . . . . . . . . . . . . . . . . . . . . . . . . . . . . . . . . . . . . = =
= = . . . . . . . . . . . . . . . . . . . . . . . . . . . . . . . . . . . . = =
= = . . . . . . . . . . . . . . . . . . . . . . . . . . . . . . . . . . . . = =
= = . . . . . . . . . . . . . . . . . . . . . . . . . . . . . . . . . . . . = =
= = . . . . . . . . . . . . . . . . . . . . . . . . . . . . . . . . . . . . = =
= = . . . . . . . . . . . . . . . . . . . . . . . . . . . . . . . . . . . . = =
= = . . . . . . . . . . . . . . . . . . . . . . . . . . . . . . . . . . . . = =
= = . . . . . . . . . . . . . . . . . . . . . . . . . . . . . . . . . . . . = =
= = . . . . . . . . . . . . . . . . . . . . . . . . . . . . . . . . . . . . = =
= = . . . . . . . . . . . . . . . . . . . . . . . . . . . . . . . . . . . . = =
= = . . . . . . . . . . . . . . . . . . . . . . . . . . . . . . . . . . . . = =
= = . . . . . . . . . . . . . . . . . . . . . . . . . . . . . . . . . . . . = =
= = = = = = = = = = = = = = = = = = = = = = = = = = = = = = = = = = = = = = = =
= = = = = = = = = = = = = = = = = = = = = = = = = = = = = = = = = = = = = = = =
