tiles.png 16 16 640 480

7 7 7 7 7 7 7 7 7 7 7 7 7 7 7 7 7 7 7 7 7 7 7 7 7 7 7 7 7 7 7 7 7 7 7 7 7 7 7 7
7 2 2 2 2 2 2 2 2 2 2 2 2 2 2 2 2 2 2 2 2 2 2 2 2 2 2 2 2 2 2 2 2 2 2 2 2 2 2 7
7 2 2 2 2 2 2 2 2 2 2 2 2 2 2 2 2 2 2 2 2 2 2 2 2 2 2 2 2 2 2 2 2 2 2 2 2 2 2 7
7 2 2 2 2 2 2 2 2 2 2 2 2 2 2 2 2 2 2 2 2 2 2 2 2 2 2 2 2 2 2 2 2 2 2 2 2 2 2 7
7 2 2 2 2 2 2 2 2 2 2 2 2 2 2 2 2 2 2 2 2 2 2 2 2 2 2 2 2 2 2 2 2 2 2 2 2 2 2 7
7 2 2 2 7 7 7 2 2 2 2 2 2 2 7 7 7 2 2 2 2 2 2 2 2 2 2 2 2 2 2 2 2 2 2 2 2 2 2 7
7 2 2 2 2 2 2 2 2 2 2 2 2 2 2 2 2 2 2 2 2 2 2 2 2 2 2 2 2 2 2 2 2 2 2 2 2 2 2 7
7 2 2 2 2 2 2 2 2 2 2 2 2 2 2 2 2 2 2 2 2 2 2 2 2 2 2 2 2 2 2 2 2 2 2 2 2 2 2 7
7 2 2 2 2 2 2 2 7 7 7 7 2 2 2 2 2 2 2 2 2 2 2 2 2 2 2 2 2 2 2 2 2 2 2 2 2 2 2 7
7 2 2 2 2 2 2 2 2 2 2 2 2 2 2 2 2 2 2 2 2 2 7 7 7 2 2 2 2 2 2 2 2 2 2 2 2 2 2 7
7 2 2 2 2 2 2 2 2 2 2 2 2 2 2 2 2 2 2 2 2 2 2 2 2 7 7 7 2 2 2 2 2 2 2 2 2 2 2 7
7 2 2 2 2 2 2 2 2 2 2 2 2 2 2 2 2 2 2 2 2 2 2 2 2 2 2 2 7 7 7 2 2 2 2 2 2 2 2 7
7 2 2 2 2 2 2 2 2 2 2 2 2 2 2 2 2 2 2 2 2 2 2 2 2 2 2 2 2 2 2 7 7 7 2 2 2 2 2 7
7 2 2 2 2 2 2 2 2 2 2 2 2 2 2 2 2 2 2 2 2 2 2 2 2 2 2 2 2 2 2 2 2 2 2 2 2 2 2 7
7 2 2 2 2 2 2 2 2 2 2 2 2 2 2 2 2 2 2 2 2 2 2 2 2 2 2 2 2 2 2 2 2 2 2 2 2 2 2 7
7 2 2 2 2 2 2 2 2 2 2 2 2 2 2 2 2 2 2 2 2 2 2 2 2 2 2 2 2 2 2 2 2 2 2 2 2 2 2 7
7 2 2 2 2 2 2 2 2 2 2 2 2 2 2 2 2 2 2 2 2 2 2 2 2 2 2 2 2 2 2 2 2 2 2 2 2 2 2 7
7 2 2 2 2 2 2 2 2 2 2 2 2 2 2 2 2 2 2 2 2 2 2 2 2 2 2 2 2 2 2 2 2 2 2 2 2 2 2 7
7 2 2 2 2 2 2 2 2 2 2 2 2 2 2 2 2 2 2 2 2 2 2 2 2 2 2 2 2 2 2 2 2 2 2 2 2 2 2 7
7 2 2 2 2 2 2 2 2 2 2 2 2 2 2 2 2 2 2 2 2 2 2 2 2 2 2 2 2 2 2 2 2 2 2 2 2 2 2 7
7 2 2 2 2 2 2 2 2 2 2 2 2 2 2 2 2 2 2 2 2 2 2 2 2 2 2 2 2 2 2 2 2 2 2 2 2 2 2 7
7 2 2 2 2 2 2 2 2 2 2 2 2 2 2 2 2 2 2 2 2 2 2 2 2 2 2 2 2 2 2 2 2 2 2 2 2 2 2 7
7 2 2 2 2 2 2 2 2 2 2 2 2 2 2 2 2 2 2 2 2 2 2 2 2 2 2 2 2 2 2 2 2 2 2 2 2 2 2 7
7 2 2 2 2 2 2 2 2 2 2 2 2 2 2 2 2 2 2 2 2 2 2 2 2 2 2 2 2 2 2 2 2 2 2 2 2 2 2 7
7 2 2 2 2 2 2 2 2 2 2 2 2 2 2 2 2 2 2 2 2 2 2 2 2 2 2 2 2 2 2 2 2 2 2 2 2 2 2 7
7 2 2 2 2 2 2 2 2 2 2 2 2 2 2 2 2 2 2 2 2 2 2 2 2 2 2 2 2 2 2 2 2 2 2 2 2 2 2 7
7 2 2 2 2 2 2 2 2 2 2 2 2 2 2 2 2 2 2 2 2 2 2 2 2 2 2 2 2 2 2 2 2 2 2 2 2 2 2 7
7 7 2 2 2 2 2 2 2 2 2 2 2 2 2 2 2 2 2 2 2 2 2 2 2 2 2 2 2 2 2 2 2 2 2 2 2 2 2 7
7 7 2 2 2 2 2 2 2 2 2 2 2 2 2 7 7 2 2 2 2 2 2 2 2 2 2 2 2 2 2 2 2 2 2 2 2 2 2 7
7 7 7 7 7 7 7 7 7 7 7 7 7 7 7 7 7 7 7 7 7 7 7 7 7 7 7 7 7 7 7 7 7 7 7 7 7 7 7 7

= = = = = = = = = = = = = = = = = = = = = = = = = = = = = = = = = = = = = = = =
= . . . . . . . . . . . . . . . . . . . . . . . . . . . . . . . . . . . . . . =
= . . . . . . . . . . . . . . . . . . . . . . . . . . . . . . . . . . . . . . =
= . . . . . . . . . . . . . . . . . . . . . . . . . . . . . . . . . . . . . . =
= . . . . . . . . . . . . . . . . . . . . . . . . . . . . . . . . . . . . . . =
= . . . = = = . . . . . . . = = = . . . . . . . . . . . . . . . . . . . . . . =
= . . . . . . . . . . . . . . . . . . . . . . . . . . . . . . . . . . . . . . =
= . . . . . . . . . . . . . . . . . . . . . . . . . . . . . . . . . . . . . . =
= . . . . . . . = = = = . . . . . . . . . . . . . . . . . . . . . . . . . . . =
= . . . . . . . . . . . . . . . . . . . . . = = = . . . . . . . . . . . . . . =
= . . . . . . . . . . . . . . . . . . . . . . . . = = = . . . . . . . . . . . =
= . . . . . . . . . . . . . . . . . . . . . . . . . . . = = = . . . . . . . . =
= . . . . . . . . . . . . . . . . . . . . . . . . . . . . . . = = = . . . . . =
= . . . . . . . . . . . . . . . . . . . . . . . . . . . . . . . . . . . . . . =
= . . . . . . . . . . . . . . . . . . . . . . . . . . . . . . . . . . . . . . =
= . . . . . . . . . . . . . . . . . . . . . . . . . . . . . . . . . . . . . . =
= . . . . . . . . . . . . . . . . . . . . . . . . . . . . . . . . . . . . . . =
= . . . . . . . . . . . . . . . . . . . . . . . . . . . . . . . . . . . . . . =
= . . . . . . . . . . . . . . . . . . . . . . . . . . . . . . . . . . . . . . =
= . . . . . . . . . . . . . . . . . . . . . . . . . . . . . . . . . . . . . . =
= . . . . . . . . . . . . . . . . . . . . . . . . . . . . . . . . . . . . . . =
= . . . . . . . . . . . . . . . . . . . . . . . . . . . . . . . . . . . . . . =
= . . . . . . . . . . . . . . . . . . . . . . . . . . . . . . . . . . . . . . =
= . . . . . . . . . . . . . . . . . . . . . . . . . . . . . . . . . . . . . . =
= . . . . . . . . . . . . . . . . . . . . . . . . . . . . . . . . . . . . . . =
= . . . . . . . . . . . . . . . . . . . . . . . . . . . . . . . . . . . . . . =
= . . . . . . . . . . . . . . . . . . . . . . . . . . . . . . . . . . . . . . =
= = . . . . . . . . . . . . . . . . . . . . . . . . . . . . . . . . . . . . . =
= = . . . . . . . . . . . . . = = . . . . . . . . . . . . . . . . . . . . . . =
= = = = = = = = = = = = = = = = = = = = = = = = = = = = = = = = = = = = = = = =
