tiles.png

1 2 3 2 4 2 1 2 3 2 4 2 1 2 3 2 4 2 1 2 3 2 4 2 1 2 3 2 4 2 1 2 3 2 4 2 1 2 3 2 1 2 3 2 4 2 1 2 3 2 4 2 1 2 3 2 4 2 1 2 3 2 4 2 1 2 3 2 4 2 1 2 3 2 4 2 1 2 3 2
2 3 2 4 2 1 2 3 2 4 2 1 2 3 2 4 2 1 2 3 2 4 2 1 2 3 2 4 2 1 2 3 2 4 2 1 2 3 2 4 2 3 2 4 2 1 2 3 2 4 2 1 2 3 2 4 2 1 2 3 2 4 2 1 2 3 2 4 2 1 2 3 2 4 2 1 2 3 2 4
3 2 4 2 1 2 3 2 4 2 1 2 3 2 4 2 1 2 3 2 4 2 1 2 3 2 4 2 1 2 3 2 4 2 1 2 3 2 4 2 3 2 4 2 1 2 3 2 4 2 1 2 3 2 4 2 1 2 3 2 4 2 1 2 3 2 4 2 1 2 3 2 4 2 1 2 3 2 4 2
2 4 2 1 2 3 2 4 2 1 2 3 2 4 2 1 2 3 2 4 2 1 2 3 2 4 2 1 2 3 2 4 2 1 2 3 2 4 2 1 2 4 2 1 2 3 2 4 2 1 2 3 2 4 2 1 2 3 2 4 2 1 2 3 2 4 2 1 2 3 2 4 2 1 2 3 2 4 2 1
4 2 1 2 3 2 4 2 1 2 3 2 4 2 1 2 3 2 4 2 1 2 3 2 4 2 1 2 3 2 4 2 1 2 3 2 4 2 1 2 4 2 1 2 3 2 4 2 1 2 3 2 4 2 1 2 3 2 4 2 1 2 3 2 4 2 1 2 3 2 4 2 1 2 3 2 4 2 1 2
2 1 2 3 2 4 2 1 2 3 2 4 2 1 2 3 2 4 2 1 2 3 2 4 2 1 2 3 2 4 2 1 2 3 2 4 2 1 2 3 2 1 2 3 2 4 2 1 2 3 2 4 2 1 2 3 2 4 2 1 2 3 2 4 2 1 2 3 2 4 2 1 2 3 2 4 2 1 2 3
1 2 3 2 4 2 1 2 3 2 4 2 1 5 5 5 5 5 5 5 5 5 5 5 5 2 3 2 4 2 1 2 3 2 4 2 1 2 3 2 1 2 3 2 4 2 1 2 3 2 4 2 1 2 3 2 4 2 1 2 3 2 4 2 1 2 3 2 4 2 1 2 3 2 4 2 1 2 3 2
2 3 2 4 2 1 2 3 2 4 2 1 2 3 2 4 2 1 2 3 2 4 2 1 2 3 2 4 2 1 2 3 2 4 2 1 2 3 2 4 2 3 2 4 2 1 2 3 2 4 2 1 2 3 2 4 2 1 2 3 2 4 2 1 2 3 2 4 2 1 2 3 2 4 2 1 2 3 2 4
3 2 4 2 1 2 3 2 4 2 1 2 3 2 4 2 1 2 3 2 4 2 1 2 3 2 4 2 1 2 3 2 4 2 1 2 3 2 4 2 3 2 4 2 1 2 3 2 4 2 1 2 3 2 4 2 1 2 3 2 4 2 1 2 3 2 4 2 1 2 3 2 4 2 1 2 3 2 4 2
2 4 2 1 2 3 2 4 2 1 2 3 2 4 2 1 2 3 2 4 2 1 2 3 2 4 2 1 2 3 2 4 2 1 2 3 2 4 2 1 2 4 2 1 2 3 2 4 2 1 2 3 2 4 2 1 2 3 2 4 2 1 2 3 2 4 2 1 2 3 2 4 2 1 2 3 2 4 2 1
4 2 1 2 3 2 4 2 1 2 3 2 4 2 1 2 3 2 4 2 1 2 3 2 4 2 1 5 5 5 5 5 5 5 5 2 4 2 1 2 4 2 1 2 3 2 4 2 1 2 3 2 4 2 1 2 3 2 4 2 1 2 3 2 4 2 1 2 3 2 4 2 1 2 3 2 4 2 1 2
2 1 2 3 2 4 2 1 2 3 2 4 2 1 2 3 2 4 2 1 2 3 2 4 2 1 2 3 2 4 2 1 2 3 2 4 2 1 2 3 2 1 2 3 2 4 2 1 2 3 2 4 2 1 2 3 2 4 2 1 2 3 2 4 2 1 2 3 2 4 2 1 2 3 2 4 2 1 2 3
1 2 3 2 4 2 1 2 3 2 4 2 1 2 3 2 4 2 1 2 3 2 4 2 1 2 3 2 4 2 1 2 3 2 4 2 1 2 3 2 1 2 3 2 4 2 1 2 3 2 4 2 1 2 3 2 4 2 1 2 3 2 4 2 1 2 3 2 4 2 1 2 3 2 4 2 1 2 3 2
2 3 2 4 2 1 2 3 2 4 2 1 2 3 2 4 2 1 2 3 2 4 2 1 2 3 2 4 2 1 2 3 2 4 2 1 2 5 5 5 5 5 5 5 5 5 5 5 5 5 5 5 5 5 5 5 5 5 5 5 5 5 5 5 5 5 5 5 5 5 5 2 1 2 3 2 4 2 1 2
3 2 5 5 5 5 5 5 5 2 1 2 3 2 4 2 1 2 3 2 4 2 1 2 3 2 4 2 1 2 3 2 4 2 1 2 3 2 4 2 3 2 4 2 1 2 3 2 4 2 1 2 3 2 4 2 1 2 3 2 4 2 1 2 3 2 4 2 1 2 3 2 4 2 1 2 3 2 4 2
2 4 2 1 2 3 2 4 2 1 2 3 2 4 2 1 2 3 2 4 2 1 2 3 2 4 2 1 2 3 2 4 2 1 2 3 2 4 2 1 2 4 2 1 2 3 2 4 2 1 2 3 2 4 2 1 2 3 2 4 2 1 2 3 2 4 2 1 2 3 2 4 2 1 2 3 2 4 2 1
4 2 1 2 3 2 4 2 1 2 3 2 4 2 1 2 3 2 4 2 1 2 3 2 4 2 1 2 3 2 4 2 1 2 3 2 4 2 1 2 4 2 1 2 3 2 4 2 1 2 3 2 4 2 1 2 3 2 4 2 1 2 3 2 4 2 1 2 3 2 4 2 1 2 3 2 4 2 1 2
2 1 2 3 2 4 2 1 2 3 2 4 2 1 2 3 2 4 2 1 2 3 2 4 2 1 2 3 2 4 2 1 2 3 2 4 2 1 2 3 2 1 2 3 2 4 2 1 2 3 2 4 2 1 2 3 2 4 2 1 2 3 2 4 2 1 2 3 2 4 2 1 2 3 2 4 2 1 2 3
1 2 3 2 4 2 1 2 3 2 4 2 1 2 3 2 4 2 1 2 3 2 4 2 1 2 3 2 4 2 1 2 3 2 4 2 1 2 3 2 1 2 3 2 4 2 1 2 3 2 4 2 1 2 3 2 4 2 1 2 3 2 4 2 1 2 3 2 4 2 1 2 3 2 4 2 1 2 3 2
2 3 2 4 2 1 2 3 2 4 2 1 2 3 2 4 2 1 2 3 2 4 2 1 2 3 2 4 2 1 2 3 2 4 2 1 2 3 2 4 2 3 2 4 2 1 2 3 2 4 2 1 2 3 2 4 2 1 2 3 2 4 2 1 2 3 2 4 2 1 2 3 2 4 2 1 2 3 2 4
3 2 4 2 1 2 3 2 4 2 1 2 3 2 4 2 1 2 3 2 4 2 1 2 3 2 4 2 1 2 3 2 4 2 1 2 3 2 4 2 3 2 4 2 1 2 3 2 4 2 1 2 3 2 4 2 1 2 3 2 4 2 1 2 3 2 4 2 1 2 3 2 4 2 1 2 3 2 4 2
2 4 2 1 2 3 2 4 2 1 2 3 2 4 2 1 2 3 2 4 2 1 2 3 2 4 2 1 2 3 2 4 2 1 2 3 2 4 2 1 2 4 2 1 2 3 2 4 2 1 2 3 2 4 2 1 2 3 2 4 2 1 2 3 2 4 2 1 2 3 2 4 2 1 2 3 2 4 2 1
4 2 1 2 3 2 4 2 1 2 3 2 4 2 1 2 3 2 4 2 1 2 3 2 4 2 1 2 3 2 4 2 1 2 3 2 4 2 1 2 4 2 1 2 3 2 4 2 1 2 3 2 4 2 1 2 3 2 4 2 1 2 3 2 4 2 1 2 3 2 4 2 1 2 3 2 4 2 1 2
2 1 2 3 2 4 2 1 2 3 2 4 2 1 2 3 2 4 2 1 2 3 2 4 2 1 2 3 2 4 2 1 2 3 2 4 2 1 2 3 2 1 2 3 2 4 2 1 2 3 2 4 2 1 2 3 2 4 2 1 2 3 2 4 2 1 2 3 2 4 2 1 2 3 2 4 2 1 2 3
5 5 5 5 5 5 5 5 5 5 5 5 5 5 5 5 5 5 5 5 5 5 5 5 5 5 5 5 5 5 5 5 5 5 5 5 5 5 5 5 5 5 5 5 5 5 5 5 5 5 5 5 5 5 5 5 5 5 5 5 5 5 5 5 5 5 5 5 5 5 5 5 5 5 5 5 5 5 5 5
6 7 8 6 7 8 6 7 8 6 7 8 6 7 8 6 7 8 6 7 8 6 7 8 6 7 8 6 7 8 6 7 8 6 7 8 6 7 8 6 7 8 6 7 8 6 7 8 6 7 8 6 7 8 6 7 8 6 7 8 6 7 8 6 7 8 6 7 8 6 7 8 6 7 8 6 7 8 6 7
7 8 6 7 8 6 7 8 6 7 8 6 7 8 6 7 8 6 7 8 6 7 8 6 7 8 6 7 8 6 7 8 6 7 8 6 7 8 6 7 8 6 7 8 6 7 8 6 7 8 6 7 8 6 7 8 6 7 8 6 7 8 6 7 8 6 7 8 6 7 8 6 7 8 6 7 8 6 7 8
8 6 7 8 6 7 8 6 7 8 6 7 8 6 7 8 6 7 8 6 7 8 6 7 8 6 7 8 6 7 8 6 7 8 6 7 8 6 7 8 6 7 8 6 7 8 6 7 8 6 7 8 6 7 8 6 7 8 6 7 8 6 7 8 6 7 8 6 7 8 6 7 8 6 7 8 6 7 8 6
6 7 8 6 7 8 6 7 8 6 7 8 6 7 8 6 7 8 6 7 8 6 7 8 6 7 8 6 7 8 6 7 8 6 7 8 6 7 8 6 7 8 6 7 8 6 7 8 6 7 8 6 7 8 6 7 8 6 7 8 6 7 8 6 7 8 6 7 8 6 7 8 6 7 8 6 7 8 6 7
7 8 6 7 8 6 7 8 6 7 8 6 7 8 6 7 8 6 7 8 6 7 8 6 7 8 6 7 8 6 7 8 6 7 8 6 7 8 6 7 8 6 7 8 6 7 8 6 7 8 6 7 8 6 7 8 6 7 8 6 7 8 6 7 8 6 7 8 6 7 8 6 7 8 6 7 8 6 7 8

+ - - - - - - - - - - - - - - - - - - - - - - - - - - - - - - - - - - - - - - - - - - - - - - - - - - - - - - - - - - - - - - - - - - - - - - - - - - - - - - +
| . . . . . . . . . . . . . . . . . . . . . . . . . . . . . . . . . . . . . . . . . . . . . . . . . . . . . . . . . . . . . . . . . . . . . . . . . . . . . . |
| . . . . . . . . . . . . . . . . . . . . . . . . . . . . . . . . . . . . . . . . . . . . . . . . . . . . . . . . . . . . . . . . . . . . . . . . . . . . . . |
| . . . . . . . . . . . . . . . . . . . . . . . . . . . . . . . . . . . . . . . . . . . . . . . . . . . . . . . . . . . . . . . . . . . . . . . . . . . . . . |
| . . . . . . . . . . . . . . . . . . . . . . . . . . . . . . . . . . . . . . . . . . . . . . . . . . . . . . . . . . . . . . . . . . . . . . . . . . . . . . |
| . . . . . . . . . . . . . . . . . . . . . . . . . . . . . . . . . . . . . . . . . . . . . . . . . . . . . . . . . . . . . . . . . . . . . . . . . . . . . . |
| . . . . . . . . . . . . - - - - - - - - - - - - . . . . . . . . . . . . . . . . . . . . . . . . . . . . . . . . . . . . . . . . . . . . . . . . . . . . . . |
| . . . . . . . . . . . . . . . . . . . . . . . . . . . . . . . . . . . . . . . . . . . . . . . . . . . . . . . . . . . . . . . . . . . . . . . . . . . . . . |
| . . . . . . . . . . . . . . . . . . . . . . . . . . . . . . . . . . . . . . . . . . . . . . . . . . . . . . . . . . . . . . . . . . . . . . . . . . . . . . |
| . . . . . . . . . . . . . . . . . . . . . . . . . . . . . . . . . . . . . . . . . . . . . . . . . . . . . . . . . . . . . . . . . . . . . . . . . . . . . . |
| . . . . . . . . . . . . . . . . . . . . . . . . . . - - - - - - - - . . . . . . . . . . . . . . . . . . . . . . . . . . . . . . . . . . . . . . . . . . . . |
| . . . . . . . . . . . . . . . . . . . . . . . . . . . . . . . . . . . . . . . . . . . . . . . . . . . . . . . . . . . . . . . . . . . . . . . . . . . . . . |
| . . . . . . . . . . . . . . . . . . . . . . . . . . . . . . . . . . . . . . . . . . . . . . . . . . . . . . . . . . . . . . . . . . . . . . . . . . . . . . |
| . . . . . . . . . . . . . . . . . . . . . . . . . . . . . . . . . . . . - - - - - - - - - - - - - - - - - - - - - - - - - - - - - - - - - - . . . . . . . . |
| . - - - - - - - . . . . . . . . . . . . . . . . . . . . . . . . . . . . . . . . . . . . . . . . . . . . . . . . . . . . . . . . . . . . . . . . . . . . . . |
| . . . . . . . . . . . . . . . . . . . . . . . . . . . . . . . . . . . . . . . . . . . . . . . . . . . . . . . . . . . . . . . . . . . . . . . . . . . . . . |
| . . . . . . . . . . . . . . . . . . . . . . . . . . . . . . . . . . . . . . . . . . . . . . . . . . . . . . . . . . . . . . . . . . . . . . . . . . . . . . |
| . . . . . . . . . . . . . . . . . . . . . . . . . . . . . . . . . . . . . . . . . . . . . . . . . . . . . . . . . . . . . . . . . . . . . . . . . . . . . . |
| . . . . . . . . . . . . . . . . . . . . . . . . . . . . . . . . . . . . . . . . . . . . . . . . . . . . . . . . . . . . . . . . . . . . . . . . . . . . . . |
| . . . . . . . . . . . . . . . . . . . . . . . . . . . . . . . . . . . . . . . . . . . . . . . . . . . . . . . . . . . . . . . . . . . . . . . . . . . . . . |
| . . . . . . . . . . . . . . . . . . . . . . . . . . . . . . . . . . . . . . . . . . . . . . . . . . . . . . . . . . . . . . . . . . . . . . . . . . . . . . |
| . . . . . . . . . . . . . . . . . . . . . . . . . . . . . . . . . . . . . . . . . . . . . . . . . . . . . . . . . . . . . . . . . . . . . . . . . . . . . . |
| . . . . . . . . . . . . . . . . . . . . . . . . . . . . . . . . . . . . . . . . . . . . . . . . . . . . . . . . . . . . . . . . . . . . . . . . . . . . . . |
| . . . . . . . . . . . . . . . . . . . . . . . . . . . . . . . . . . . . . . . . . . . . . . . . . . . . . . . . . . . . . . . . . . . . . . . . . . . . . . |
+ - - - - - - - - - - - - - - - - - - - - - - - - - - - - - - - - - - - - - - - - - - - - - - - - - - - - - - - - - - - - - - - - - - - - - - - - - - - - - - +
| . . . . . . . . . . . . . . . . . . . . . . . . . . . . . . . . . . . . . . . . . . . . . . . . . . . . . . . . . . . . . . . . . . . . . . . . . . . . . . |
| . . . . . . . . . . . . . . . . . . . . . . . . . . . . . . . . . . . . . . . . . . . . . . . . . . . . . . . . . . . . . . . . . . . . . . . . . . . . . . |
| . . . . . . . . . . . . . . . . . . . . . . . . . . . . . . . . . . . . . . . . . . . . . . . . . . . . . . . . . . . . . . . . . . . . . . . . . . . . . . |
| . . . . . . . . . . . . . . . . . . . . . . . . . . . . . . . . . . . . . . . . . . . . . . . . . . . . . . . . . . . . . . . . . . . . . . . . . . . . . . |
| . . . . . . . . . . . . . . . . . . . . . . . . . . . . . . . . . . . . . . . . . . . . . . . . . . . . . . . . . . . . . . . . . . . . . . . . . . . . . . |
