tiles.png

7 7 7 7 7 7 7 7 7 7 7 7 7 7 7 7 7 7 7 7 7 7 7 7 7 7 7 7 7 7 7 7 7 7 7 7 7 7 7 7 7 7 7 7 7 7 7 7 7 7 7 7 7 7 7 7 7 7 7 7 7 7 7 7 7 7 7 7 7 7 7 7 7 7 7 7 7 7 7 7
7 3 2 4 2 1 2 3 2 4 2 1 2 3 2 4 2 1 2 3 2 4 2 1 2 3 2 4 2 1 2 3 2 4 2 1 2 3 2 4 2 3 2 4 2 1 2 3 2 4 2 1 2 3 2 4 2 1 2 3 2 4 2 1 2 3 2 4 2 1 2 3 2 4 2 1 2 3 2 7
7 2 4 2 1 2 3 2 4 2 1 2 3 2 4 2 1 2 3 2 4 2 1 2 3 2 4 2 1 2 3 2 4 2 1 2 3 2 4 2 3 2 4 2 1 2 3 2 4 2 1 2 3 2 4 2 1 2 3 2 4 2 1 2 3 2 4 2 1 2 3 2 4 2 1 2 3 2 4 7
7 4 2 1 2 3 2 4 2 1 2 3 2 4 2 1 2 3 2 4 2 1 2 3 2 4 2 1 2 3 2 4 2 1 2 3 2 4 2 1 2 4 2 1 2 3 2 4 2 1 2 3 2 4 2 1 2 3 2 4 2 1 2 3 2 4 2 1 2 3 2 4 2 1 2 3 2 4 2 7
7 2 1 2 3 2 4 2 1 2 3 2 4 2 1 2 3 2 4 2 1 2 3 2 4 2 1 2 3 2 4 2 1 2 3 2 4 2 1 2 4 2 1 2 3 2 4 2 1 2 3 2 4 2 1 2 3 2 4 2 1 2 3 2 4 2 1 2 3 2 4 2 1 2 3 2 4 2 1 7
7 1 2 3 2 4 2 1 2 3 2 4 2 1 2 3 2 4 2 1 2 3 2 4 2 1 2 3 2 4 2 1 2 3 2 4 2 1 2 3 2 1 2 3 2 4 2 1 2 3 2 4 2 1 2 3 2 4 2 1 2 3 2 4 2 1 2 3 2 4 2 1 2 3 2 4 2 1 2 7
7 2 3 2 4 2 1 2 3 2 4 2 1 5 5 5 5 5 5 5 5 5 5 5 5 2 3 2 4 2 1 2 3 2 4 2 1 2 3 2 1 2 3 2 4 2 1 2 3 2 4 2 1 2 3 2 4 2 1 2 3 2 4 2 1 2 3 2 4 2 1 2 3 2 4 2 1 2 3 7
7 3 2 4 2 1 2 3 2 4 2 1 2 3 2 4 2 1 2 3 2 4 2 1 2 3 2 4 2 1 2 3 2 4 2 1 2 3 2 4 2 3 2 4 2 1 2 3 2 4 2 1 2 3 2 4 2 1 2 3 2 4 2 1 2 3 2 4 2 1 2 3 2 4 2 1 2 3 2 7
7 2 4 2 1 2 3 2 4 2 1 2 3 2 4 2 1 2 3 2 4 2 1 2 3 2 4 2 1 2 3 2 4 2 1 2 3 2 4 2 3 2 4 2 1 2 3 2 4 2 1 2 3 2 4 2 1 2 3 2 4 2 1 2 3 2 4 2 1 2 3 2 4 2 1 2 3 2 4 7
7 4 2 1 2 3 2 4 2 1 2 3 2 4 2 1 2 3 2 4 2 1 2 3 2 4 2 1 2 3 2 4 2 1 2 3 2 4 2 1 2 4 2 1 2 3 2 4 2 1 2 3 2 4 2 1 2 3 2 4 2 1 2 3 2 4 2 1 2 3 2 4 2 1 2 3 2 4 2 7
7 2 1 2 3 2 4 2 1 2 3 2 4 2 1 2 3 2 4 2 1 2 3 2 4 2 1 5 5 5 5 5 5 5 5 2 4 2 1 2 4 2 1 2 3 2 4 2 1 2 3 2 4 2 1 2 3 2 4 2 1 2 3 2 4 2 1 2 3 2 4 2 1 2 3 2 4 2 1 7
7 1 2 3 2 4 2 1 2 3 2 4 2 1 2 3 2 4 2 1 2 3 2 4 2 1 2 3 2 4 2 1 2 3 2 4 2 1 2 3 2 1 2 3 2 4 2 1 2 3 2 4 2 1 2 3 2 4 2 1 2 3 2 4 2 1 2 3 2 4 2 1 2 3 2 4 2 1 2 7
7 2 3 2 4 2 1 2 3 2 4 2 1 2 3 2 4 2 1 2 3 2 4 2 1 2 3 2 4 2 1 2 3 2 4 2 1 2 3 2 1 2 3 2 4 2 1 2 3 2 4 2 1 2 3 2 4 2 1 2 3 2 4 2 1 2 3 2 4 2 1 2 3 2 4 2 1 2 3 7
7 3 2 4 2 1 2 3 2 4 2 1 2 3 2 4 2 1 2 3 2 4 2 1 2 3 2 4 2 1 2 3 2 4 2 1 2 5 5 5 5 5 5 5 5 5 5 5 5 5 5 5 5 5 5 5 5 5 5 5 5 5 5 5 5 5 5 5 5 5 5 2 1 2 3 2 4 2 1 7
7 2 5 5 5 5 5 5 5 2 1 2 3 2 4 2 1 2 3 2 4 2 1 2 3 2 4 2 1 2 3 2 4 2 1 2 3 2 4 2 3 2 4 2 1 2 3 2 4 2 1 2 3 2 4 2 1 2 3 2 4 2 1 2 3 2 4 2 1 2 3 2 4 2 1 2 3 2 4 7
7 4 2 1 2 3 2 4 2 1 2 3 2 4 2 1 2 3 2 4 2 1 2 3 2 4 2 1 2 3 2 4 2 1 2 3 2 4 2 1 2 4 2 1 2 3 2 4 2 1 2 3 2 4 2 1 2 3 2 4 2 1 2 3 2 4 2 1 2 3 2 4 2 1 2 3 2 4 2 7
7 2 1 2 3 2 4 2 1 2 3 2 4 2 1 2 3 2 4 2 1 2 3 2 4 2 1 2 3 2 4 2 1 2 3 2 4 2 1 2 4 2 1 2 3 2 4 2 1 2 3 2 4 2 1 2 3 2 4 2 1 2 3 2 4 2 1 2 3 2 4 2 1 2 3 2 4 2 1 7
7 1 2 3 2 4 2 1 2 3 2 4 2 1 2 3 2 4 2 1 2 3 2 4 2 1 2 3 2 4 2 1 2 3 2 4 2 1 2 3 2 1 2 3 2 4 2 1 2 3 2 4 2 1 2 3 2 4 2 1 2 3 2 4 2 1 2 3 2 4 2 1 2 3 2 4 2 1 2 7
7 2 3 2 4 2 1 2 3 2 4 2 1 2 3 2 4 2 1 2 3 2 4 2 1 2 3 2 4 2 1 2 3 2 4 2 1 2 3 2 1 2 3 2 4 2 1 2 3 2 4 2 1 2 3 2 4 2 1 2 3 2 4 2 1 2 3 2 4 2 1 2 3 2 4 2 1 2 3 7
7 3 2 4 2 1 2 3 2 4 2 1 2 3 2 4 2 1 2 3 2 4 2 1 2 3 2 4 2 1 2 3 2 4 2 1 2 3 2 4 2 3 2 4 2 1 2 3 2 4 2 1 2 3 2 4 2 1 2 3 2 4 2 1 2 3 2 4 2 1 2 3 2 4 2 1 2 3 2 7
7 2 4 2 1 2 3 2 4 2 1 2 3 2 4 2 1 2 3 2 4 2 1 2 3 2 4 2 1 2 3 2 4 2 1 2 3 2 4 2 3 2 4 2 1 2 3 2 4 2 1 2 3 2 4 2 1 2 3 2 4 2 1 2 3 2 4 2 1 2 3 2 4 2 1 2 3 2 4 7
7 4 2 1 2 3 2 4 2 1 2 3 2 4 2 1 2 3 2 4 2 1 2 3 2 4 2 1 2 3 2 4 2 1 2 3 2 4 2 1 2 4 2 1 2 3 2 4 2 1 2 3 2 4 2 1 2 3 2 4 2 1 2 3 2 4 2 1 2 3 2 4 2 1 2 3 2 4 2 7
7 2 1 2 3 2 4 2 1 2 3 2 4 2 1 2 3 2 4 2 1 2 3 2 4 2 1 2 3 2 4 2 1 2 3 2 4 2 1 2 4 2 1 2 3 2 4 2 1 2 3 2 4 2 1 2 3 2 4 2 1 2 3 2 4 2 1 2 3 2 4 2 1 2 3 2 4 2 1 7
7 1 2 3 2 4 2 1 2 3 2 4 2 1 2 3 2 4 2 1 2 3 2 4 2 1 2 3 2 4 2 1 2 3 2 4 2 1 2 3 2 1 2 3 2 4 2 1 2 3 2 4 2 1 2 3 2 4 2 1 2 3 2 4 2 1 2 3 2 4 2 1 2 3 2 4 2 1 2 7
5 5 5 5 5 5 5 5 5 5 5 5 5 5 5 5 5 5 5 5 5 5 5 5 5 5 5 5 5 5 5 5 5 5 5 5 5 5 5 5 5 5 5 5 5 5 5 5 5 5 5 5 5 5 5 5 5 5 5 5 5 5 5 5 5 5 5 5 5 5 5 5 5 5 5 5 5 5 5 5
6 7 8 6 7 8 6 7 8 6 7 8 6 7 8 6 7 8 6 7 8 6 7 8 6 7 8 6 7 8 6 7 8 6 7 8 6 7 8 6 7 8 6 7 8 6 7 8 6 7 8 6 7 8 6 7 8 6 7 8 6 7 8 6 7 8 6 7 8 6 7 8 6 7 8 6 7 8 6 7
7 8 6 7 8 6 7 8 6 7 8 6 7 8 6 7 8 6 7 8 6 7 8 6 7 8 6 7 8 6 7 8 6 7 8 6 7 8 6 7 8 6 7 8 6 7 8 6 7 8 6 7 8 6 7 8 6 7 8 6 7 8 6 7 8 6 7 8 6 7 8 6 7 8 6 7 8 6 7 8
8 6 7 8 6 7 8 6 7 8 6 7 8 6 7 8 6 7 8 6 7 8 6 7 8 6 7 8 6 7 8 6 7 8 6 7 8 6 7 8 6 7 8 6 7 8 6 7 8 6 7 8 6 7 8 6 7 8 6 7 8 6 7 8 6 7 8 6 7 8 6 7 8 6 7 8 6 7 8 6
6 7 8 6 7 8 6 7 8 6 7 8 6 7 8 6 7 8 6 7 8 6 7 8 6 7 8 6 7 8 6 7 8 6 7 8 6 7 8 6 7 8 6 7 8 6 7 8 6 7 8 6 7 8 6 7 8 6 7 8 6 7 8 6 7 8 6 7 8 6 7 8 6 7 8 6 7 8 6 7
7 8 6 7 8 6 7 8 6 7 8 6 7 8 6 7 8 6 7 8 6 7 8 6 7 8 6 7 8 6 7 8 6 7 8 6 7 8 6 7 8 6 7 8 6 7 8 6 7 8 6 7 8 6 7 8 6 7 8 6 7 8 6 7 8 6 7 8 6 7 8 6 7 8 6 7 8 6 7 8

= = = = = = = = = = = = = = = = = = = = = = = = = = = = = = = = = = = = = = = = = = = = = = = = = = = = = = = = = = = = = = = = = = = = = = = = = = = = = = = =
= . . . . . . . . . . . . . . . . . . . . . . . . . . . . . . . . . . . . . . . . . . . . . . . . . . . . . . . . . . . . . . . . . . . . . . . . . . . . . . =
= . . . . . . . . . . . . . . . . . . . . . . . . . . . . . . . . . . . . . . . . . . . . . . . . . . . . . . . . . . . . . . . . . . . . . . . . . . . . . . =
= . . . . . . . . . . . . . . . . . . . . . . . . . . . . . . . . . . . . . . . . . . . . . . . . . . . . . . . . . . . . . . . . . . . . . . . . . . . . . . =
= . . . . . . . . . . . . . . . . . . . . . . . . . . . . . . . . . . . . . . . . . . . . . . . . . . . . . . . . . . . . . . . . . . . . . . . . . . . . . . =
= . . . . . . . . . . . . . . . . . . . . . . . . . . . . . . . . . . . . . . . . . . . . . . . . . . . . . . . . . . . . . . . . . . . . . . . . . . . . . . =
= . . . . . . . . . . . . = = = = = = = = = = = = . . . . . . . . . . . . . . . . . . . . . . . . . . . . . . . . . . . . . . . . . . . . . . . . . . . . . . =
= . . . . . . . . . . . . . . . . . . . . . . . . . . . . . . . . . . . . . . . . . . . . . . . . . . . . . . . . . . . . . . . . . . . . . . . . . . . . . . =
= . . . . . . . . . . . . . . . . . . . . . . . . . . . . . . . . . . . . . . . . . . . . . . . . . . . . . . . . . . . . . . . . . . . . . . . . . . . . . . =
= . . . . . . . . . . . . . . . . . . . . . . . . . . . . . . . . . . . . . . . . . . . . . . . . . . . . . . . . . . . . . . . . . . . . . . . . . . . . . . =
= . . . . . . . . . . . . . . . . . . . . . . . . . . = = = = = = = = . . . . . . . . . . . . . . . . . . . . . . . . . . . . . . . . . . . . . . . . . . . . =
= . . . . . . . . . . . . . . . . . . . . . . . . . . . . . . . . . . . . . . . . . . . . . . . . . . . . . . . . . . . . . . . . . . . . . . . . . . . . . . =
= . . . . . . . . . . . . . . . . . . . . . . . . . . . . . . . . . . . . . . . . . . . . . . . . . . . . . . . . . . . . . . . . . . . . . . . . . . . . . . =
= . . . . . . . . . . . . . . . . . . . . . . . . . . . . . . . . . . . . = = = = = = = = = = = = = = = = = = = = = = = = = = = = = = = = = = . . . . . . . . =
= . = = = = = = = . . . . . . . . . . . . . . . . . . . . . . . . . . . . . . . . . . . . . . . . . . . . . . . . . . . . . . . . . . . . . . . . . . . . . . =
= . . . . . . . . . . . . . . . . . . . . . . . . . . . . . . . . . . . . . . . . . . . . . . . . . . . . . . . . . . . . . . . . . . . . . . . . . . . . . . =
= . . . . . . . . . . . . . . . . . . . . . . . . . . . . . . . . . . . . . . . . . . . . . . . . . . . . . . . . . . . . . . . . . . . . . . . . . . . . . . =
= . . . . . . . . . . . . . . . . . . . . . . . . . . . . . . . . . . . . . . . . . . . . . . . . . . . . . . . . . . . . . . . . . . . . . . . . . . . . . . =
= . . . . . . . . . . . . . . . . . . . . . . . . . . . . . . . . . . . . . . . . . . . . . . . . . . . . . . . . . . . . . . . . . . . . . . . . . . . . . . =
= . . . . . . . . . . . . . . . . . . . . . . . . . . . . . . . . . . . . . . . . . . . . . . . . . . . . . . . . . . . . . . . . . . . . . . . . . . . . . . =
= . . . . . . . . . . . . . . . . . . . . . . . . . . . . . . . . . . . . . . . . . . . . . . . . . . . . . . . . . . . . . . . . . . . . . . . . . . . . . . =
= . . . . . . . . . . . . . . . . . . . . . . . . . . . . . . . . . . . . . . . . . . . . . . . . . . . . . . . . . . . . . . . . . . . . . . . . . . . . . . =
= . . . . . . . . . . . . . . . . . . . . . . . . . . . . . . . . . . . . . . . . . . . . . . . . . . . . . . . . . . . . . . . . . . . . . . . . . . . . . . =
= . . . . . . . . . . . . . . . . . . . . . . . . . . . . . . . . . . . . . . . . . . . . . . . . . . . . . . . . . . . . . . . . . . . . . . . . . . . . . . =
= = = = = = = = = = = = = = = = = = = = = = = = = = = = = = = = = = = = = = = = = = = = = = = = = = = = = = = = = = = = = = = = = = = = = = = = = = = = = = = =
= . . . . . . . . . . . . . . . . . . . . . . . . . . . . . . . . . . . . . . . . . . . . . . . . . . . . . . . . . . . . . . . . . . . . . . . . . . . . . . =
= . . . . . . . . . . . . . . . . . . . . . . . . . . . . . . . . . . . . . . . . . . . . . . . . . . . . . . . . . . . . . . . . . . . . . . . . . . . . . . =
= . . . . . . . . . . . . . . . . . . . . . . . . . . . . . . . . . . . . . . . . . . . . . . . . . . . . . . . . . . . . . . . . . . . . . . . . . . . . . . =
= . . . . . . . . . . . . . . . . . . . . . . . . . . . . . . . . . . . . . . . . . . . . . . . . . . . . . . . . . . . . . . . . . . . . . . . . . . . . . . =
= . . . . . . . . . . . . . . . . . . . . . . . . . . . . . . . . . . . . . . . . . . . . . . . . . . . . . . . . . . . . . . . . . . . . . . . . . . . . . . =
